//R 1920 1280
//R 1024    768
F 230, 230, 230
//R 640 480
R 1280 720
   NO    ./pathtomap


        1111111111111111111111111
        1000000000110000000000001
        1011000001110000002000001
        1001000000000000000000001
111111111011000001110000000000001
100000000011000001110111110111111
11110111111111011100000010001
11110111111111011101010010001
11000000110101011100000010001
10002000000000001100001010001
1000000000000000110100101000111111
110000011101010111110111100N100001
11110111 1110101 10111100000111111
11111111 1111111 111111111111