R 1367 1000
//        R 1920 1080
R 1024    768
F 20, 223, 250,
C 140, 40, 20
//R 640 1280
//R 640 480
//R 320 240
//R 640 1200
//R 768 768
//R 1280 480
NO    ./wwood.xpm
SO    ./wbricks.xpm
EA    ./wstone.xpm
WE    ./woodwall.xpm

        1111111111111111111111111
        1000000000110000000000001
        1011000001110000002000001
        1001000000000000000000001
111111111011000001110000000000001
100000000011000111110111110111111
11110111111111010000000010001
11110111111111010101010010001
11010101010101010000000010001
10002000000000000001010000001
1001010101010100110001101000111111
110101011101010111110111100N100001
11110111 1110101 10111100000111111
11111111 1111111 111111111111