R 1920 1280
//R 1280 720
   NO    ./pathtomap


        1111111111111111111111111
        1000000000110000000000001
        1011000001110000002000001
        1001000000000000000000001
111111111011000001110000000000001
100000000011000001110111110111111
11110111111111011100000010001
11110111111111011101010010001
11000000110101011100000000001
10002000000000001100000000001
10000000000000001101000000001
110000011101010111110110000N1
11110111 1110101 101111000001
11111111 1111111 111111111111