//R 1920 1280
R 640 480
   NO    ./pathtomap


        1111111111111111111111111
        1000000000000000000000001
        1111000000000000002000001
        1011000000000000000000001
111111111011000000000000000000001
100000000011000000000000000011111
11110111111100000000000000001
10000000000000000000000000001
11000000000000000000000000001
10002000000000000000000000001
10000000000000000000000001001
100000000000000000000000010N1
10000000000000000000000001001
11111111111111111111111111111