#R 1367 1000
        R 1920 1080
#R 160 120
#R 1024    768
.R 640 480
//7 320 240
#R 768 768

C 140, 23, 50
F 140, 40, 20

NO    ./src/wwood.xpm
SO    ./src/wbricks.xpm
EA    ./src/wstone.xpm
WE    ./src/woodwall.xpm
S     ./src/marble.xpm

        1111111111111111111111111
        1000000000110002222222201
        1011000001110002222222201
        1001000000000002222222201
111111111011000001110000000000001
100000000011000111110111110111111
11110111111111010000000010001
11110111111111010101010010001
11010101010101010000000010001
10002000000000000001010000001
1001010101010100110001101000111111
110101011101010111110111100N100001
11110111 1110101 10111100000111111
11111111 1111111 111111111111