R 1920 1080

C  55, 23,  55
F 90, 99, 108

NO    ./src/wblocks.xpm
SO    ./src/widk.xpm
EA    ./src/widk.xpm
WE    ./src/wblocks.xpm
S     ./src/marblet.xpm

        1111111111111111111111111
        1000000000110000000000001
        1011000001110000000000001
        1001000000000000000000001
111111111011000001110000000000001
100000000011000111110111110111111
11110111111111010000000010001
11110111111111010101010010001
11010101010101010000000010021
10000000000000000001010000001
1001010101010100110001101000111111
110101011101010111110111100N000001
11110111 1110101 10111100000111111
11111111 1111111 111111111111
