R 1920 1080

C 180, 25, 180
F 20, 99, 108

NO    ./textures/wwood.xpm
SO    ./textures/wstone.xpm
EA    ./textures/wbricks.xpm
WE    ./textures/widk.xpm
S     ./textures/sphere.xpm

        1111111111111111111111111
        1000200000110000000000001
        1011000001110000000000001
        1001000000000000002000001
111111111011000001110000000000001
100000200011000111110111110111111
11110111111111010000000010001
11110111111111010101010010201
11010101010101010000000010001
10000000000000000001010000001
1001010101010100110001101000111111
110101011101010111110111100N000001
11110111 1110101 10111100000111111
11111111 1111111 111111111111
