R       1152      648

C    200,    25,  170
F  20,   099,  090

NO    ./textures/5.xpm
SO    ./textures/5.xpm
EA    ./textures/9.xpm
WE    ./textures/9.xpm
S     ./textures/meshd.xpm

11111111111111111111
12222222102000000011
122222222011020001111111111111111
122222221001000000000000200000001
111111111011000001110000000000001
100000000011000111110111110111111
11110111111111010000012222221
   101       1010000012222221
   10111111111010000002222111
   1000000000000E0200111011
   11111111111111111111111
