R 1920 1080

C 180, 25, 180
F 20, 99, 108

NO    ./textures/5.xpm
SO    ./textures/5.xpm
EA    ./textures/thing.xpm
WE    ./textures/thing.xpm
S     ./textures/marbled.xpm

11111111111111111111
10000000100000000011
100020000011002001111111111111111
100000001001000000000000200000001
111111111011000001110000000000001
100000020011000111110111110111111
11110111111111012000010000001
11110111111111010000010002001
11110111111111010000000000111
1111E000000000000200011101111
11111111111111111111111111111
